../game/tileset.png
2222002222222222222222222
2000000000000000000000222
2000000000000000000000222
2000000000000000000000222
2000000000000000000000222
2000567805999800000000222
2000222222222222000000222
2000000000000000000322222
2000000000000000003222222
2000000000000000032222222
2000000000000000322222222
2000000000000003222222222
2000000000000032222222222
2000000000000322222222222
2000000000003222222222222
2000000000032222222222222
2000000010000000000000000
2000000034000000000000000
2000000322400000000000000
2000003222240000000000000
2000032222224000000000000
2001322222222400000000000
2003222222222240000000056
2222222222222224000000322
2222222222222222405996222